11111111111111111111111111111111
1P...........C.................1
1..............................1
1.......11111111111111.........1
1.......1............1.........1
1.......1.......D.....1........1
1.......1............1.........1
1.......11111111111111.........1
1..............2...............1
1..............2...............1
1..............N...............1
11111111111111111111111111111111
