11111111111111111111111111111111
1P...........C.................1
1..............................1
1.......11111111111111.........1
1.......1............1.........1
1.......1.......D....1.........1
1.......1............1.........1
1.......1111111.111111.........1
1..............2...............1
1..............2...............1
1..............................1
111111111111111N1111111111111111
