1111111111111111111111111111111111111111111111
1G..........................................G1
1.11111111111111111111111111111111111111111..1
1.1........................................1.1
1.1.1111111111111111111111111111111111111.1..1
1.1.1...................................1.1..1
1.1.1.111111111111111111111111111111111.1.1..1
1.1.1.1G.......M.......A.......G......1.1.1..1
1.1.1.1................................1.1.1.1
1.1.1.111111111111111111111111111111111.1.1..1
1.1.1...................................1.1..1
1.1.1111111111111111111111111111111111111.1..1
1.1.......................................1..1
1.11111111111111111111111111111111111111111..1
1............................................1
1..111111111111111111111111111111111111111...1
1..1......................................1..1
1..1..G...A...M...G...A...M...G...A...M...1..1
1..1......................................1..1
1..111111111111111111111111111111111111111...1
1............................................1
RP..........................................MN
1............................................1
1..111111111111111111111111111111111111111...1
1..1......................................1..1
1..1..M...G...A...M...G...A...M...G.......1..1
1..1......................................1..1
1..111111111111111111111111111111111111111...1
1............................................1
1111111111111111111111111111111111111111111111
